BIJLAGE 7 LIJST VAN AFKORTINGEN
AO = Algemeen Overleg
AAR = Air to Air Refuelling
ABNL = Admiraal Benelux
ABP = Algemeen Burgerlijk Pensioenfonds
AC = Aanmeld Centra
AGS = Alliance Ground Surveillance
AIVD = Algemene Inlichtingen- en Veiligheidsdienst
AOCS = Air Operations Control Station
ASE = Aircraft Survivability Equipment
AVI = Afdeling Verbindingsinlichtingen
AWACS = Airborne Warning and Control System
BBE = Bijzondere Bijstands Eenheid
BDR = Battle Damage Repair
BDZ = Bevelhebber der Zeestrijdkrachten
BHMAC = Bosnia-Herzegowina Mine Action Centre
BIMS = Bureau Internationale Militaire Sport
BKAC = Bosnia Kosovo Air Component
BLS = Bevelhebber der Landstrijdkrachten
BMC4I = Battlefield Management Command, Control,
Communication, Computerisation and
Intelligence
BMS = Battlefield Management System
BSOA = Beleidsvoorbereiding, Specialistisch Onderzoek
en Advies
BTW = Belasing Toegevoegde Waarde
BUIZA = (Ministerie van) Buitenlandse Zaken
BZK = (Ministerie van) Binnenlandse Zaken en
Koninkrijksrelaties
C2 = Command and Control
C2SC = Command and Control Support Centre
CAMS = Centrum voor Automatisering van Missie-
kritieke Systemen
CBMS = Centrale Beheersorganisatie Militair Salaris-
systeem
CBRN = Chemisch, Biologisch, Radiologisch en Nucleair
CDV = Competitieve Dienst Verlening
CIMIC = Civil-Military Cooperation
CIS = Commando- en Informatiesystemen
CKMARNS = Commandant van het Korps Mariniers
CKW = Commandant Kustwacht
CMBA = Civiel-Militaire Bestuursafspraken
CMH = Centraal Militair Hospitaal
CO = Centrale Organisatie
COA = Centrale Opvang Asielzoekers
COLPRO = Collective Protection
CRC = Control and Reporting Centre
CSSC = Combat Support and Support Command
CTG = Commander Task Group
CTM = Centrum voor Technologie en Missie-
ondersteuning
CVP = Concept Validation Phase
CZMCARIB = Commandant der Zeemacht in het Caribisch
Gebied
CZMNED = Commandant der Zeemacht Nederland
Tweede Kamer, vergaderjaar 2003–2004, 29 200 hoofdstuk X, nr. 2 222

IRT = Immediate Respons Team
ISAF = International Security Assistance Force
ISTAR = Intelligence Surveillance, Target Acquisition
and Reconnaissance
IV = Informatievoorziening
JDAM = Joint Direct Attack Munition
JIATF = Joint Inter Agency Task Force
JOP = Jaarlijks Oefen Programma
JSF = Joint Strike Fighter
JSOC = Junior Staff Officers Course
JUS = (Ministerie van) Justitie
KFOR = Kosovo Force
KIM = Koninklijk Instituut voor de Marine
KL = Koninklijke Landmacht
KLU = Koninklijke Luchtmacht
KM = Koninklijke Marine
KMA = Koninklijke Militaire Academie
KMAR = Koninklijke Marechaussee
KMSL = Koninklijke Militaire School Luchtmacht
KNLWM = Koninklijk Nederlands Leger- en Wapen-
museum («Generaal Hoefer»)
KSG = Koninklijke Schelde Groep
KTOMM = Koninklijk Tehuis voor Oud-Militairen en
Museum
KWNA&A = Kustwacht Nederlandse Antillen en Aruba
KWNED = Kustwacht Nederland
LAS = Landmachtstaf
LBB = Landelijk Bevoorradingsbedrijf
LCF = Luchtverdedigings- en Commandofregat
LCKLu = Logistiek Centrum Koninklijke Luchtmacht
LDR = Logistieke Divisie Rhenen
LDW = Logistieke Divisie Woensdrecht
LO/S = Lichamelijke Oefening- en Sportorganisatie
LPD = Landing Platform Dock
LTBF = Long Term Build-up Forces
LVB = Licht Verkennings- en Bewakingsvoertuig
MALE = Medium Altitude Long Endurance
MAP = Membership Action Plan
MARNSBAT = Mariniersbataljon
MASS = Militairy Approach and Surveillance System
MATLOGCO = Materieel-Logistiek Commando
MB = Marinebedrijf
MCW = Mechanisch Centrale Werkplaats
MDD = Maatschappelijke Dienst Defensie
ME = Mobiele Eenheid
MEDEVAC = Medische Evacuatie
MGFB = Militair Geneeskundig Facilitair Bedrijf
MGLC = Militair Geneeskundig Logistiek Centrum
MILATCC = Military Air Traffic Control Centre
MILSATCOM = Militaire Satelliet Communicatie
MIVD = Militaire Inlichtingen- en Veiligheidsdienst
MJO = Meerjaarlijks Onderhoud
MLU = Midlife Update
MNB = Multinationale Brigade
MOB = Main Operating Base
MOC = Mariniersopleidingscentrum
Tweede Kamer, vergaderjaar 2003–2004, 29 200 hoofdstuk X, nr. 2 224

RVE = Resultaat Verantwoordelijke Eenheid
SAR = Search and Rescue
SBK = Sociaal Beleidskader
SFIR = Stabilization Force Iraque
SFOR = Stabilization Force
SHORAD = Short Range Air Defence
SM = Standard Missile
SMART = Specifiek, Meetbaar, Acceptabel, Realistisch en
Tijdgebonden
SMP = Soldier Modernization Programme
SOSTAR = Stand-Off Surveillance Target Acquisition Radar
(Equipment)
SRAT = Short Range Antitank
SSM = Single Service Management
SSP = Single Service Procurement
STOAG = Stichting Bijzondere Scholen op Algemene
Grondslag
TACTIS = Tactische Indoor Simulatie
TBMD = Theater Ballistic Missile Defence (System)
TDN = Topografische Dienst
TGP = Target Pods
THG/KLU = Tactische Helikoptergroep Koninklijke Lucht-
macht
TITAAN = Theatre Independent Tactical Army and Airforce
Network
TL = Tactische Luchtmacht
TNO-DO = (Nederlandse organisatie voor) Toegepast
Natuurwetenschappelijk Onderzoek – Defensie
Onderzoek
TROPCO = Trekkeropleggercombinatie
TTO = Tussentijds Onderhoud
UKW = Uitkeringswet Gewezen Militairen
UNIFIL = United Nations Interim Force in Lebanon
UNTSO = United Nations Truce Supervision Organisation
URAV = Unmanned Reconnaissance Aerial Vehicle
VBTB = Van Beleidsbegroting tot Beleids-
verantwoording
VLB = Vliegbasis
VN = Verenigde Naties
VOA = Verhaalswet Ongevallen Ambtenaren
VROM = (Ministerie van) Volkshuisvesting, Ruimtelijke
Ordening en Milieubeheer
VT = Veldtenue
VTE = Volletijdsequivalenten
VWS = (Ministerie van) Volksgezondheid, Welzijn en
Sport
WLS = Wissellaadsystemen
WOO = Wetenschappelijk Onderzoek en Ontwikkeling
WW = Werkloosheidswet
ZBO = Zelfstandig Bestuursorgaan
ZVD = Ziektekostenvoorziening Defensiepersoneel
Tweede Kamer, vergaderjaar 2003–2004, 29 200 hoofdstuk X, nr. 2 226

